Transaction Date,Transaction Type,Sort Code,Account Number,Transaction Description,Debit Amount,Credit Amount,Balance
28/03/2022,FPI,11-22-33,12345678,GARCIA COS O,,1510,1638.17
18/03/2022,SO,11-22-33,12345678,GARCIA COSTA O,1500,,128.17
07/03/2022,DD,11-22-33,12345678,AVIVA LIFE,50,,1628.17
03/03/2022,DD,11-22-33,12345678,E.ON NEXT,70,,1703.29
02/03/2022,DEP,11-22-33,12345678,CLUB LLOYDS WAIVED,,3,1773.29
02/03/2022,PAY,11-22-33,12345678,CLUB LLOYDS FEE,3,,1770.29
01/03/2022,,11-22-33,12345678,INTEREST (GROSS),,0.57,1773.29
28/02/2022,FPI,11-22-33,12345678,GARCIA COS O,,1510,1772.72
